1111111111111111111111111111111
10010000000C0000000000000000001
10000111110000000C000000000C001
1P0011E0000000000000000C0000001
100000000000000000C000000000001
1111111111111111111111111111111