11111
1PE01
11C01
100C1
11111



