


11111
1PEC1
11001
10001
11111